10
IIIIIIIIII
ISEEEEEEEI
IEIIEIEIEI
IEIEEIEIEI
IEEEIIEIEI
IIEIIEEEEI
IEEEEEIIII
IEIIIEEEEI
IEEEEEIIXI
IIIIIIIIII
10
IIIIIIIIII
ISEBEEBEEI
IEIIEIEIEI
IBIEEIEIEI
IEEBIIEIEI
IIBIIBEEEI
IEEBEEIIII
IBIIIEEEBI
IEEEBEIIEI
IIIIIIIIII
