10
IIIIIIIIII
ISEBEEBEEI
IEIIEIEIEI
IBIEEIEIEI
IEEBIIEIEI
IIBIIBEEEI
IEEBEEIIII
IBIIIEEEBI
IEEEBEIIEI
IIIIIIIIII
